11111111111111111111
10000000000000000551
15001000001100000051
15001001111111100001
10001000001100000001
10001000000000000001
10000000000011100101
10000000000001000111
10111111001001000011
10100001001000000011
10111101001111110011
10000101000000010011
10111101000000000001
10000001000011111001
11111111111111111111
eSG
cJM
aDJ
bEL
dSN