11111111111111111111
10005550005511111061
16605550105501000061
10600000105501006661
10601111105501000001
10601000000000000051
10001000000066000551
10111000666066000051
10000000666066666001
10005500666066000001
11005500000066000101
11000000000000000101
11000000010000011101
11111000111055000001
11111111111111111111
aBD
bRB
dMC
hFI
iCM
eLI
fRI
gOJ
cRM