11111111111111111111
10011110055000011111
10011100055000000111
10011066055000600011
16000000055011100001
15500000055011005501
15550000000000000501
15555000066055060001
10000000000055060001
10001000055000000001
10011100055000055551
10001000055000000001
10000000155000060001
10006611155555000001
11111111111111111111
bRL
gCM
hJI
fLM
aMD
eKG
dHK
cHB