11111111111111111111
10000000010000000001
10061111110000100001
11060000000660106601
11066005150660106601
11006601110660106001
11100600000000106661
11110605550000100001
11100605550011111051
11006605550000000051
11066005550066666051
11060005550000600011
10060005550550600011
10000005550550001111
11111111111111111111
aIB
bNB
eED
fQB
cRF
gSH
hOJ
dFE
jKN
iON