11111111111111111111
10111111000000000501
10100000011111110501
10000111111111110501
15500000000000000001
10000555050505550501
10000005050505000501
10555505056505555501
10611605050505111101
10555505000005060101
10000001111111060001
10550000000000060001
15555006666666000551
11115500006000060551
11111111111111111111
cKJ
bOG
dSL
hOJ
gQF
eFC
jQD
iPM
aBL
fJN