11111111111111111111
10000000000000000111
11111000006000000011
10001000006000010001
10101000111110010001
10111000000000010601
10000000001000010601
10001100011100010601
10001100001000010001
10000005000005000001
10555555010105555501
10000000010100000001
10111111110111111101
10000000000000000001
11111111111111111111
aDE
dKL
cEN
iSG
bRC
gLC
ePN