11111111111111111111
10100011000011000001
10110000000000011101
10000000011100000101
10011100010000000101
10011100010000000001
10010000010000000001
10010000010011111001
10000011010000000001
10000010010000100001
10000011110000100001
11000000000000100001
11000000000001110001
11110000000000000011
11111111111111111111
dPL
cKE
bSB
aHJ